; Labirinto 2
7 20 3
####################
#S..##$##..b..A.##E#
##.....T.#.....###.#
##.#B...c..D####...#
#d..#...##T#.....#.#
#$TT#..a........C#$#
####################